4  4
2  0  1  1  h
0  1  2  1  h
1  0  1  1  v
1  1  2  1  h
1  3  1  1  v
2  1  1  1  v
2  2  1  1  v
2  3  1  1  v
3  0  1  1  v
3  1  2  1  h