4  4
1  0  1  1  h
0  1  1  2  v
0  2  1  2  v
2  1  1  1  h
2  2  1  1  h
3  1  1  1  h
3  2  1  1  h
3  3  1  1  v