4  4
1  2  1  1  h
0  0  1  1  h
0  1  1  1  h
0  3  1  1  v
1  0  1  1  v
1  1  1  1  b
1  3  1  1  v
2  0  1  1  v
2  1  1  1  b
2  2  1  1  b
2  3  1  1  v
3  0  1  1  v
3  1  1  1  h
3  2  1  1  h
3  3  1  1  h