5  5
3  2  2  1  h
0  0  1  1  h
0  2  1  2  v
0  4  1  1  h
1  0  1  1  h
1  3  1  1  h
2  4  1  1  v
3  0  1  2  v
3  4  1  2  v
