4  4
3  1  2  1  b
1  1  1  1  b
1  2  1  1  b
2  1  1  1  b
2  3  2  1  b
3  3  1  2  b
4  1  2  1  b
4  4  1  1  b