4  4
1  1  2  1  h
0  3  1  2  v
1  0  1  1  v
2  0  1  1  v
2  1  1  1  v
2  2  2  1  h
3  0  2  1  h