4  4
1  0  2  1  h
0  3  1  2  v
1  2  1  1  b
2  0  1  2  v
2  1  1  1  b
2  2  1  1  h
3  1  2  1  h