6  6
2  0  2  1  h
0  0  1  2  v
0  3  1  3  v
0  4  1  2  v
1  1  2  1  h
1  5  1  2  v
2  2  1  2  v
2  4  1  2  v
3  0  2  1  h
4  2  1  2  v